NO ./texture/wall_north.xpm

EA ./texture/wall_east.xpm
WE ./texture/wall_west.xpm
SO ./texture/wall_south.xpm


F 220,100,0
C 225,30,00


1111111111111111111111111111111
1111111000000000110000000000001
111000001110000000000001111111
100100000000000000000000111111111
111111111011000001110000000000001
100000000011000001110111111111111
11110111111111011100000010001     
11110111111111011101010010001 
110000001101010111000010100011111
1000000000000000000101010100010001
100000000000000011010100100111111
11000001110101011111011110N0111
11110111 1110101 101111010001
11111111 1111111 111111111111
